1111111111111111111111111111111111
1111110000000000C000000C0000111111
1111110111111111111111111110111111
1111110100000W00000000000010111111
1111110101000011111111111110111111
1111110101000000000000000010111111
1111110101000000000000000010111111
1111110101111111111111111110111111
1111110100000000000000000000111111
1111110111111111111111111111111111
111111000000C00E00P000C00000111111
1111111111111111111111111111111111